000000001000000
000000001000000
000000001000000
000001110000000
000000000000000
000000000000000
000000000000000
111000000000000
001000000000000
000000110000000
000000100001111
000000100000000
111000000000000
001000000000000
000000010000000
000000011100001
000000000000000
000100000000000
000100000000000
000100000000000
