000001000000000
000001000000000
000001000000000
000000000000000
000000000000001
000000000000001
000000000000001
000010000010001
000010000010000
000010000010000
000000000000000
000000000000000
000000000010000
000000000010001
000100001110001
111100001000000
000000000000000
000000000000000
000000000000000
000000010000000
